10, 10, 10, 10, 10, 10, 10, 10, 10, 10, 10, 10, 10, 10, 10, 10, 
10, 10, 10, 10, 10, 10, 10, 10,
10, 0, 0, 0, 6, 0, 0, 0, 0, 0, 6, 1, 0, 0, 0, 6, 
0, 1, 0, 0, 0, 0, 0, 10,
10, 0, 0, 0, 6, 6, 0, 0, 7, 0, 6, 8, 6, 0, 0, 6, 
6, 0, 0, 0, 0, 0, 0, 10,
10, 0, 0, 0, 0, 0, 0, 0, 0, 0, 0, 0, 0, 0, 0, 0, 
0, 0, 0, 0, 0, 0, 0, 10,
10, 0, 0, 0, 0, 0, 0, 0, 0, 0, 0, 0, 0, 0, 0, 7, 
0, 0, 0, 0, 0, 0, 0, 10,
10, 0, 0, 0, 0, 0, 0, 0, 0, 0, 0, 0, 0, 0, 0, 0, 
0, 0, 0, 0, 0, 0, 0, 10,
10, 0, 0, 0, 6, 0, 0, 1, 6, 6, 0, 1, 6, 0, 0, 0, 
2, 0, 0, 0, 0, 0, 0, 10,
10, 0, 0, 0, 0, 6, 1, 6, 0, 8, 0, 6, 0, 6, 5, 6, 
1, 6, 0, 6, 0, 0, 0, 10,
10, 0, 0, 0, 0, 0, 6, 0, 0, 0, 9, 0, 7, 0, 6, 0, 
4, 0, 6, 0, 0, 0, 0, 10,
10, 0, 0, 0, 0, 0, 0, 0, 0, 0, 0, 0, 0, 0, 0, 4, 
0, 0, 0, 0, 0, 0, 0, 10,
10, 0, 0, 0, 0, 0, 0, 0, 0, 0, 0, 0, 0, 0, 0, 0, 
0, 0, 0, 0, 0, 0, 0, 10,
10, 0, 0, 0, 0, 0, 0, 0, 0, 0, 0, 0, 0, 0, 0, 0, 
0, 0, 0, 0, 0, 0, 0, 10,
10, 10, 10, 10, 10, 10, 10, 10, 10, 10, 10, 10, 10, 10, 10, 10, 
10, 10, 10, 10, 10, 10, 10, 10